#Participant List 228 participants 34th B2GM as of 20190929
Abner	Soffer	
Ai	Nishikawa	
Alberto	Martini	
Alejandro	Mora Grimaldo	
Alessandro	Gaz	
Alexander	Kuzmin	
Alexey	Garmash	
Andreas	Warburton	
Andrii	Natochii	
Angelo	Di Canto	
Anna	Vinokurova	
Anselm Georg	Vossen	
Armine	Rostomyan	
Ba-Ro	Kim	
Beigbeder	Christophe	
Bjoern	Spruck	
Boqun	Wang	
Boris	Shwartz	
Bostjan	Golob	
ByungGu	Cheon	
Caleb	Miller	
Carlos	Marinas	
Carlos Fernando	Gamboa	
Carsten	Niebuhr	
Chia-Ling	Hsu	
Christian	Irmler	
Christian	Wessel	
Christoph	Schwanda	
Christopher	Hearty	
Christopher	Ketter	
Christos	Hadjivasiliou	
Claudia	Cecchi	
Cyrille	Praz	
Daniel	Cervenkov	
Daniel	Charlet	
David	Dossett	
David	Jaffe	
Dhiraj	Kalita	
Diego	Tonelli	
Dmitri	Liventsev	
Dmitrii	Neverov	
Dmytro	Levit	
Elisa	Manoni	
Eric	Lancon	
Eunil	Won	
Eunji	Jang	
Ewan	Hill	
Ezio	Torassa	
Fabrizio	Ameli	
Fabrizio	Bianchi	
Fernando Jesus	Abudinen	
Francesco	Forti	
Francesco	Tenchini	
Frank	Meier	
Gagan	Mohanty	
Gao	BaoSheng	
Gary	Varner	
Gennaro	Tortone	
Gevorg	Nazaryan	
Gianluca	Inguglia	
Giulia	Casarosa	
Giulio	Dujany	
Giuseppe	Finocchiaro	
Guney	Polat	
Hans-Guenter	Moser	
Haruki	Kindo	
Hayato	Kitamura	
Hideki	Miyake	
Hikari	Hirata	
Hikaru	Tanigawa	
Hironori	Ito	
Hisaki	Hayashii	
Hua	Ye	
Hulya	Atmacan	
Ichiro	Adachi	
Ida Marena	Peruzzi	
Iijima	Toru	
Ilya	Komarov	
Irina	Heinz	
Jaeyeon	Kim	
Jake	Bennett	
Jakub	Kandra	
James	Kahn	
Jan	Strube	
Jaroslaw	Wiechczynski	
Jerome	Baudot	
Jia	Tao	
Jincheng	Mei	
Jingwen	Li	
Jingzhou	Zhao	
Jitendra	Kumar	
Jo	Yamanouchi	
Karim	Trabelsi	
Kato	Yuji	
Katsuro	Nakamura	
Kazutaka	Sumisawa	
Kentaro	Kuze	
Kevin	Flood	
Kevin	Varvell	
Kodai	Matsuoka	
Koji	Hara	
Kokoro	Maehara	
Kospalage	Suravinda Janaka Kumara	
Kosuke	Furui	
Kota	Nakagiri	
Kristina	Gudkova	
Kunxian	Huang	
Ladislav	Andricek	
Leo	Piilonen	
Leonardo	Salinas	
Leonardo Benjamin	Rizzuto	
Leonid	Burmistrov	
Lorenzo	Vitale	
Luigi	Corona	
Lukas	Bierwirth	
Makoto	Takizawa	
Manish	Chahal	
Marcello	Campajola	
Marco	Milesi	
Mario	Posocco	
Markus	Friedl	
Markus	Prim	
Markus	RÃ¶hrken	
Martin	Bessner	
Martin	Sevior	
Marxil	Sanchez Garcia	
Masaki	Kobayashi	
Masanobu	Yonenaga	
Masato	Tsurufuji	
Matthew	Barrett	
Michael	Ritzert	
Michel	Bertemes	
Michel	Villanueva	
Miho	Fujii	
Mikhail	Remnev	
Mikihiko	Nakao	
Minakshi	Nayak	
Ming-Chuan	Chang	
Nadia Ejlal	Toutounji	
Nanae	Taniguchi	
Nataliia	Kovalchuk	
Nisar	Nellikunnummel	
Noritsugu	Tsuzuki	
Norman Wilfrido	Molina	
Olga	Werbycka	
Oskar	Hartbrich	
Pablo	Goldenzweig	
Paolo	Branchini	
Paoti	Chang	
Patrick	Robbe	
Paul	Feichtinger	
Paul	Laycock	
Pavel	Krokovny	
Pavel	Pakhlov	
Peter	Kodys	
Petteri	Kettunen	
Philip	Grace	
Qidong	Zhou	
Qingyuan	Liu	
Racha	Cheaib	
Rajesh Kumar	Maiti	
Reem	Rasheed	
Riccardo	de Sangro	
Richard	Peschke	
Richard	Thalmeier	
Robert	Karl	
Roberto	Mussa	
Roberto	Stroili	
Ruslan	Mashinistov	
Ryosuke	Itoh	
Sam	Cunliffe	
Samo	Korpar	
Satoru	Yamada	
Saurabh	Sandilya	
Sen	Jia	
Seokhee	Park	
Shanette Anne	De La Motte	
Shohei	Nishida	
Shoji	Uno	
Shuji	Tanaka	
Siarhei	Padolski	
Silvio	Pardi	
Simon	Kurz	
Simon	Wehle	
Slavomira	Stefkova	
Sourav	Dey	
Stefano	Lacaprara	
Stefano	Spataro	
Steven	Robertson	
Tadeas	Bilka	
Takanori	Hara	
Takeo	Higuchi	
Takuto	Kunigo	
Thibaud	Humair	
Thomas	Browder	
Thomas	Mueller	
Thomas Michael.Gerd	Kraetzschmar	
Todd	Pedlar	
Tomaz	Podobnik	
Torben	Ferber	
Trevor	Shillington	
Tristan	Fillinger	
Ueda	Ikuo	
Umberto	Tamponi	
Unno	Yuji	
Vasily	Shebalin	
Vipin	Gaur	
Watanuki	Shun	
Wei	Shan	
Wencheng	Yan	
Wolfgang	Kuehn	
Xiaolong	Wang	
Yifan	Jin	
Yin	Hao	
Yinghui	Guan	
Yo	Sato	
Yongkyu	Kim	
Yoshihito	Iwasaki	
Yosuke	Yusa	
Yu-Tan	Chen	
Yuka	Higuchi	
Yuki	Sue	
Yuma	Uematsu	
Yun-Tsung	Lai	
Yutaka	Ushiroda	
Zachary	Liptak	
Zdenek	Dolezal	
Zhiqing	Liu
